R         1200          800
NO              texture_xpm/wall1.xpm
WE        texture_xpm/wall2.xpm
SO     texture_xpm/wall3.xpm
EA texture_xpm/wall4.xpm
S texture_xpm/sprite1.xpm
F          0,163,15  

C       168,192,25 

          1
         121
        121
         1
 111111111111111111111111       111111
10000000000000000000000011111111100001111111
100000000000001111111000000000000022000000001
120000E00000001     100001111111100001111101          1
10000000200000011111100001     1111111   101         101
 1101111111110000000001111       1       101        10001
  121        111111111111       121      101         101
   1                           12101     101          1
                                1001  111101111
           1                     11   100000001
          121                         100222001
           121                        100222001
            1                         100222001
                                      100000001
                                      111111111
